21 21 1 1 20 20
#####################
#S··#···#···········#
###·###·#·#####·#####
#·#···#·#·#···#·····#
#·###·#·#·#·#·#####·#
#···#·#·····#···#···#
#·###·###########·#·#
#·#···#·········#·#·#
#·#·###·#######·#·###
#·#·#···#·#···#·#···#
#·#·#·###·#·#·#·#·#·#
#·#···#···#·#···#·#·#
#·#######·#·#######·#
#·········#·····#···#
#·#·###########·#·###
#·#·········#···#···#
#·#########·#·#####·#
#·#·······#···#···#·#
#·###·###·#####·#·#·#
#·····#·········#··E#
#####################