15 15 1 1 14 14
###############
#S····#·······#
#·#·#·#·#####·#
#·#·#·#·····#·#
#·#·#·#####·#·#
#···#·····#·#·#
###·#####·#·#·#
#···#···#·#·#·#
#·#·#·#·#·#·#·#
#·#·#·#·#·#·#·#
#·#···#·#···#·#
#·#####·#####·#
#·····#·····#·#
#·#####·###·#E#
###############